
































[Strings]
SceInfAdministrator = "Administrator"
SceInfAdmins = "Administrators"
SceInfAcountOp = "Accountoperators"
SceInfAuthUsers = "Geverifieerde gebruikers"
SceInfBackupOp = "Back-upoperators"
SceInfDomainAdmins = "Domeinadministrators"
SceInfDomainGuests = "Domeingasten"
SceInfDomainUsers = "Domeingebruikers"
SceInfEnterpriseDCs = "Ondernemingsdomeincontrollers"
SceInfEveryone = "Iedereen"
SceInfGuests = "Gasten"
SceInfGuest = "Gast"
SceInfLocalService = "Lokale service"
SceInfNetworkService = "Netwerkservice"
SceInfPowerUsers = "Hoofdgebruikers"
SceInfPrintOp = "Printeroperators"
SceInfProgramFiles = "%ProgramFiles%"
SceInfProgramFilesx86 = "%ProgramFiles(x86)%"
SceInfCommonProgramFiles = "%CommonProgramFiles%"
SceInfRemoteDesktopUsers = "Externe bureaubladgebruikers"
SceInfReplicator = "Replicatie"
SceInfServerOp = "Serveroperators"
SceInfUsers = "Gebruikers"
SceInfMTSAdmins = "MTS-administrators"
SceInfMTSImpersonators = "MTS-impersonators"
SceInfMTSAdmin = "MTS_Admin"
SCEInfSysdir1 = "edit.com"
SCEInfSysdir2 = "edit.hlp"
SCEInfHelp1 = "signin.hlp"
