

[Strings]
Msft = "Microsoft"

ALG-DispName                = "Brama warstwy aplikacji"
RasCli-DispName             = "Klient telefonowania"
RasMan-DispName             = "Mened¿er po³¹czeñ us³ugi Dostêp zdalny"
RasSrv-DispName             = "Serwer telefonowania"
Steelhead-DispName          = "Steelhead"

Snapin-Desc                 = "Routing i dostêp zdalny"
Snapin-Group-Name           = "Narzêdzia administracyjne"
Snapin-HelpText             = "Skorzystaj z opcji Routing i dostêp zdalny, aby skonfigurowaæ i zarz¹dzaæ us³ug¹ routingu i dostêpu zdalnego."
Nt4RasAdmin-Desc            = "Administracja us³ugi Routing i dostêp zdalny"
Nt4RasAdmin-Group-Name      = "Narzêdzia administracyjne"

Svc-ALG-DispName            = "Us³uga bramy warstwy aplikacji"
Svc-ALG-Description         = "Zapewnia obs³ugê dodatków protoko³ów na poziomie aplikacji i w³¹cza po³¹czenia korzystaj¹ce z sieci/protoko³ów. Jeœli ta us³uga zostanie wy³¹czona, wszelkie us³ugi jawnie od niej zale¿ne przestan¹ siê uruchamiaæ."
Svc-RasAcd-DispName         = "Sterownik automatycznego po³¹czenia dostêpu zdalnego"
Svc-RasAuto-DispName        = "Mened¿er autopo³¹czenia dostêpu zdalnego"
Svc-RasAuto-Description     = "Wykrywa nieudane próby wykonania po³¹czeñ z sieci¹ zdaln¹ lub komputerem i dostarcza alternatywne metody po³¹czeñ. Jeœli ta us³uga zostanie zatrzymana, u¿ytkownicy bêd¹ musieli ³¹czyæ siê rêcznie. Jeœli ta us³uga zostanie wy³¹czona, wszelkie us³ugi jawnie od niej zale¿ne przestan¹ siê uruchamiaæ."
Svc-RasMan-DispName         = "Mened¿er po³¹czeñ us³ugi Dostêp zdalny"
Svc-RasMan-Description      = "Zarz¹dza po³¹czeniami telefonicznymi i po³¹czeniami wirtualnej sieci prywatnej (VPN) wykonywanymi z tego komputera do Internetu lub innych sieci zdalnych. Jeœli ta us³uga zostanie zatrzymana, system operacyjny mo¿e nie dzia³aæ w³aœciwie. Jeœli ta us³uga zostanie wy³¹czona, wszelkie us³ugi jawnie od niej zale¿ne przestan¹ siê uruchamiaæ."
Svc-RemoteAccess-DispName   = "Routing i dostêp zdalny"
Svc-RemoteAccess-Description = "Zapewnia us³ugi routingu w œrodowisku wieloprotoko³owym LAN-to-LAN, LAN-to-WAN, wirtualnej sieci prywatnej (VPN) i translatora adresów sieciowych (NAT) dla klientów i serwerów w tej sieci. Jeœli ta us³uga zostanie zatrzymana, us³ugi te bêd¹ niedostêpne. Jeœli ta us³uga zostanie wy³¹czona, wszelkie us³ugi jawnie od niej zale¿ne przestan¹ siê uruchamiaæ."
Svc-IpFilter-DispName       = "Sterownik filtru ruchu IP"
Svc-IpInIp-DispName         = "Sterownik IP w tunelu IP"
Svc-IpNat-DispName          = "Translator adresów sieciowych IP"
Svc-IpxFilter-DispName      = "Sterownik filtru ruchu IPX"
Svc-IpxForwarder-DispName   = "Sterownik us³ug przesy³ania dalej ruchu IPX"
Svc-NwSapAgent-DispName     = "Agent SAP"
Svc-SharedAccess-DispName   = "Zapora po³¹czenia internetowego / Udostêpnianie po³¹czenia internetowego"
Svc-SharedAccess-Description = "Zapewnia us³ugi translacji adresów sieciowych, adresowania, rozpoznawania nazw i/lub blokowania dostêpu intruzów wszystkim komputerom w sieci domowej lub biurowej. Jeœli ta us³uga zostanie zatrzymana, us³ugi sieciowe, takie jak udostêpnianie Internetu, rozpoznawanie nazw, adresowanie i/lub blokowanie dostêpu intruzom bêd¹ niedostêpne. Jeœli ta us³uga zostanie wy³¹czona, wszelkie us³ugi jawnie od niej zale¿ne przestan¹ siê uruchamiaæ."
RtrMgr-Ip-DispName          = "Mened¿er routingu TCP/IP"
RtrMgr-Ip-AutoDhcp-DispName = "Program przydzielania DHCP"
RtrMgr-Ip-Bootp-DispName    = "Agent przekazywania DHCP"
RtrMgr-Ip-DnsProxy-DispName = "Agent proxy DNS"
RtrMgr-Ip-H323-DispName     = "Agent Proxy H.323"
RtrMgr-Ip-Igmp-DispName     = "Router i serwer proxy IGMP"
RtrMgr-Ip-Nat-DispName      = "Translator adresów sieciowych (NAT)"
RtrMgr-Ip-Ospf-DispName     = "Wykorzystanie najkrótszej œcie¿ki (OSPF)"
RtrMgr-Ip-Rip-DispName      = "RIP w wersji 2 dla Internet Protocol"
RtrMgr-Ip-Alg-DispName      = "Us³uga bramy warstwy aplikacji (np. FTP)"
RtrMgr-Ip-Ftp-DispName      = "Agent proxy FTP"
RtrMgr-Ipx-DispName         = "Mened¿er routingu dla IPX"
RtrMgr-Ipx-Rip-DispName     = "RIP dla IPX"
RtrMgr-Ipx-Sap-DispName     = "SAP dla IPX"

Nt-Authentication           = "Uwierzytelnianie systemu Windows"
Nt-Accounting               = "Ksiêgowanie systemu Windows"
Radius-Authentication       = "Uwierzytelnianie us³ugi RADIUS"
Radius-Accounting           = "Ksiêgowanie us³ugi RADIUS"

Eap-DispName                = "Karta inteligentna lub inny certyfikat"
PEAP-DispName				= "Chroniony protokó³ EAP (PEAP)"
EAPMSCHAP-DispName			= "Bezpieczne has³o (EAP-MSCHAP v2)"
Chap-DispName               = "MD5-Challenge"

ConnFolderName              = "Po³¹czenia sieciowe"
ConnFolderSubDir            = "Akcesoria\Komunikacja"
ConnFolderTip               = "@%systemroot%\system32\netshell.dll,-1201"

NCW-Name                    = "Kreator nowego po³¹czenia"
NCW-SubDir                  = "Akcesoria\Komunikacja"
NCW-ToolTip                 = "@%systemroot%\system32\netshell.dll,-1011"

CmDefaultCmdKeyName         = "Connection Manager Profile"
