

[Strings]
Msft = "Microsoft"

Mp-AsyncMac-DispName        = "Adaptér pro asynchronní pøipojení RAS"
Mp-L2tp-DispName            = "WAN Miniport (L2TP)"
Mp-Irda-DispName            = "Port pro infraèervený pøenos"
Mp-IrModem-DispName         = "Port modemu pro infraèervený pøenos"
Mp-Irda-LineName            = "Pøímé pøipojení infraèerveným pøenosem"
Mp-IrModem-LineName         = "Pøímé pøipojení modemem pro infraèerveným pøenosem"
Mp-Pptp-DispName            = "Pøipojení WAN Miniport (PPTP)"
Mp-Pptp-LineName            = "Linka RAS VPN"
;Mp-Pptp-LineName must use ANSI characters, not UNICODE.
Mp-Pti-DispName             = "Pøímé propojení paralelním kabelem"
Mp-Atalk-DispName           = "WAN Miniport (AppleTalk)"
Mp-Bh-DispName              = "WAN Miniport (Sledování sítì)"
Mp-Ip-DispName              = "WAN Miniport (IP)"
Mp-Ipx-DispName             = "WAN Miniport (IPX)"
Mp-NbfIn-DispName           = "WAN Miniport (NetBEUI, pøíchozí)"
Mp-NbfOut-DispName          = "WAN Miniport (NetBEUI, odchozí)"
Mp-Pppoe-DispName           = "WAN Miniport (PPPOE)"
Mp-Pppoe-LineName           = "Linka RAS PPPOE"

Svc-Mp-AsyncMac-DispName    = "Ovladaè asynchronních médií pøipojení RAS"
Svc-Mp-L2tp-DispName        = "WAN Miniport (L2TP)"
Svc-Mp-Irda-DispName        = "WAN Miniport (IrDA)"
Svc-Mp-IrModem-DispName     = "WAN Miniport (IrDA Modem)"
Svc-Mp-Pptp-DispName        = "Pøipojení WAN Miniport (PPTP)"
Svc-Mp-Pti-DispName         = "Pøímé propojení paralelním kabelem"
Svc-NdisTapi-DispName       = "Ovladaè Remote Access NDIS TAPI"
Svc-NdisWan-DispName        = "Ovladaè Remote Access NDIS WAN"
Svc-PptpProtocol-DispName   = "Ovladaè protokolu PPTP"
Svc-Ptilink-DispName        = "Direct Parallel Link Driver"
Svc-WanArp-DispName         = "Ovladaè Remote Access IP ARP"
Svc-Mp-Pppoe-DispName       = "Ovladaè pro vzdálený pøístup PPPOE"


