

































[Strings]

;================================ Accounts ============================================================================
;Specified in UI code - Accounts: Administrator account status
;Specified in UI code - Accounts: Guest account status
;Specified in UI code - Accounts: Rename administrator account
;Specified in UI code - Accounts: Rename guest account
LimitBlankPasswordUse = "Úèty: Omezit použití prázdného hesla místního úètu pouze pro pøihlášení ke konzole"


;================================ Audit ===============================================================================
AuditBaseObjects="Audit: Auditovat pøístup globálních systémových objektù"
FullPrivilegeAuditing="Audit: Auditovat oprávnìní k zálohování a obnovení dat"
CrashOnAuditFail="Audit: Není-li možno protokolovat auditování zabezpeèení, vypnout okamžitì systém"

;================================ Devices =============================================================================
AllocateDASD="Zaøízení: vysunutí a formátování vymìnitelných médií je povoleno."
AllocateDASD0="Administrators"
AllocateDASD1="Skupiny Administrators a Power Users"
AllocateDASD2="Skupiny Administrators a Interactive Users"
AddPrintDrivers="Zaøízení: Zabránit uživatelùm instalovat ovladaèe tiskáren"
AllocateCDRoms="Zaøízení: Omezit pøístup k jednotce CD-ROM pouze na uživatele pøihlášené místnì"
AllocateFloppies="Zaøízení: Omezit pøístup k disketové jednotce pouze na uživatele pøihlášené místnì"
DriverSigning="Zaøízení: Chování pøi instalaci nepodepsaného ovladaèe"
DriverSigning0="Povolit bez upozornìní "
DriverSigning1="Zobrazit upozornìní a povolit instalaci"
DriverSigning2="Nepovolit instalaci"
UndockWithoutLogon="Zaøízení: Povolit vyjmutí z dokovací stanice bez nutnosti pøihlásit se"

;================================ Domain controller ====================================================================
SubmitControl="Øadiè domény: Povolit operátorùm serveru (Server Operators) plánovat úlohy"
RefusePWChange="Øadiè domény: Nepovolit zmìnu hesla úètu poèítaèe"
LDAPServerIntegrity = "Øadiè domény: Požadavky podepisování serveru LDAP"
LDAPServer1 = "Není k dispozici"
LDAPServer2 = "Požaduje podepsání"

;================================ Domain member ========================================================================
DisablePWChange="Èlen domény: Nepovolit zmìnu hesla úètu poèítaèe"
MaximumPWAge="Èlen domény: Maximální doba platnosti hesla úètu poèítaèe"
SignOrSeal="Èlen domény: Vždy digitálnì zašifrovat nebo podepsat data zabezpeèeného kanálu"
SealSecureChannel="Èlen domény: Je-li možno, digitálnì zašifrovat data zabezpeèeného kanálu"
SignSecureChannel="Èlen domény: Je-li možno, digitálnì podepsat data zabezpeèeného kanálu"
StrongKey="Èlen domény: Vyžadovat silný klíè relace (Windows 2000 nebo vyšší)"

;================================ Interactive logon ====================================================================
DisableCAD = "Interaktivní pøihlašování: Nevyžadovat stisknutí kláves Ctrl+Alt+Del"
DontDisplayLastUserName = "Interaktivní pøihlašování: Nezobrazovat naposledy použité uživatelské jméno"
LegalNoticeText = "Interaktivní pøihlašování: Text zprávy pro uživatele pokoušející se pøihlásit"
LegalNoticeCaption = "Interaktivní pøihlašování: Nadpis zprávy pro uživatele pokoušející se pøihlásit"
CachedLogonsCount = "Interaktivní pøihlašování: Poèet pøedchozích pøihlášení uložených v mezipamìti pro pøípad, že øadiè domény není k dispozici"
PasswordExpiryWarning = "Interaktivní pøihlašování: Vyzvat uživatele ke zmìnì hesla pøed jeho vypršením"
ForceUnlockLogon = "Interaktivní pøihlašování: Požadovat ovìøení øadièem domény k odemknutí pracovní stanice"
ScForceOption = "Interaktivní pøihlašování: Požadovat kartu Smart Card"
ScRemove = "Interaktivní pøihlašování: Chování pøi odebrání karty Smart Card"
ScRemove0 = "Žádná akce"
ScRemove1 = "Uzamknout pracovní stanici"
ScRemove2 = "Vynutit odhlášení"

;================================ Microsoft network client =============================================================
RequireSMBSignRdr="Klient sítì Microsoft: Vždy digitálnì podepsat komunikaci"
EnableSMBSignRdr="Klient sítì Microsoft: Pokud server souhlasí, digitálnì podepsat komunikaci"
EnablePlainTextPassword="Klient sítì Microsoft: Serverùm SMB tøetích stran odesílat nezašifrované heslo"

;================================ Microsoft network server =============================================================
AutoDisconnect="Server sítì Microsoft: Požadovaná délka neèinnosti pøed odpojením relace"
RequireSMBSignServer="Server sítì Microsoft: Vždy digitálnì podepsat komunikaci"
EnableSMBSignServer="Server sítì Microsoft: Pokud klient souhlasí, digitálnì podepsat komunikaci"
EnableForcedLogoff="Server sítì Microsoft: Automaticky odpojit uživatele po uplynutí doby pøihlášení (místní)"

;================================ Network access =======================================================================
;Specified in UI code - Network access: Allow anonymous SID/Name translation
DisableDomainCreds = "Pøístup k síti: Nepovolit ukládání povìøení a hesel .NET Passport k ovìøování k síti"
RestrictAnonymousSAM = "Pøístup k síti: Nepovolit anonymní tvorbu výètu úètù SAM"
RestrictAnonymous = "Pøístup k síti: Nepovolit anonymní tvorbu výètu úètù SAM a sdílených položek"
EveryoneIncludesAnonymous = "Pøístup k síti: Použít oprávnìní úètu Everyone pro anonymní uživatele"
RestrictNullSessAccess = "Pøístup k síti: Omezit anonymní pøístup k pojmenovaným kanálùm a sdíleným položkám"
NullPipes = "Pøístup k síti: Povolit anonymní pøístup k pojmenovaným kanálùm"
NullShares = "Pøístup k síti: Sdílené položky s povoleným anonymním pøístupem"
AllowedPaths = "Pøístup k síti: Vzdálenì pøístupné cesty registru a jejich podøízené vìtve."
AllowedExactPaths = "Pøístup k síti: Vzdálenì pøístupné cesty registru"
ForceGuest = "Pøístup k síti: Model sdílení a zabezpeèení místních úètù"
Classic = "Klasický - ovìøovat místní uživatele pod jejich uživatelským jménem"
GuestBased = "Pouze hosté - ovìøovat místní uživatele jako úèet Guest"

;================================ Network security =====================================================================
;Specified in UI code - Network security: Enforce logon hour restrictions
NoLMHash = "Zabezpeèení sítì: Neukládat hodnot hash systému LAN Manager pøi pøíští zmìnì hesla"
LmCompatibilityLevel = "Zabezpeèení sítì: Úroveò ovìøování pro systém LAN Manager"
LMCLevel0 = "Odeslat odpovìdi LM a NTLM"
LMCLevel1 = "Odeslat LM & NTLM - v pøípadì vyjednání použít zabezpeèení relace NTLM verze 2"
LMCLevel2 = "Odesílat pouze odpovìdi NTLM"
LMCLevel3 = "Odesílat pouze odpovìdi NTLM verze 2"
LMCLevel4 = "Odesílat pouze odpovìdi NTLM verze 2 a odmítat odpovìdi LM"
LMCLevel5 = "Odesílat pouze odpovìdi NTLM verze 2 a odmítat odpovìdi LM & NTLM"
NTLMMinClientSec = "Zabezpeèení sítì: Minimální zabezpeèení relací klientù na základì NTLM SSP vèetnì zabezpeèeného volání RPC"
NTLMMinServerSec = "Zabezpeèení sítì: Minimální zabezpeèení relací serverù na základì NTLM SSP vèetnì zabezpeèeného volání RPC"
NTLMIntegrity = "Požadovat integritu zprávy"
NTLMConfidentiality = "Požadovat dùvìrnost zprávy"
NTLMv2Session = "Požadovat zabezpeèení relací NTLMv2"
NTLM128 = "Požadovat 128 bitové šifrování"
LDAPClientIntegrity = "Zabezpeèení sítì: Požadavky podepisování klienta LDAP"
LDAPClient0 = "Žádné"
LDAPClient1 = "Vyjednat podepisování"
LDAPClient2 = "Požaduje podepisování"

;================================ Recovery console ====================================================================
RCAdmin="Konzola pro zotavení: Umožnit automatické pøihlášení správce"
RCSet="Konzola pro zotavení: Umožnit kopírování disket a pøístup ke všem jednotkám a složkám"

;================================ Shutdown ============================================================================
ShutdownWithoutLogon="Vypnutí: Povolit vypnutí systému bez nutnosti pøihlášení"
ClearPageFileAtShutdown="Vypnutí: Vyèistit stránkovací soubor virtuální pamìti"

ProtectionMode = "Systémové objekty: Posílit výchozí oprávnìní k interním systémovým objektùm (napø. symbolické odkazy)"
NoDefaultAdminOwner = "Systémové objekty: Výchozí vlastník objektù vytvoøených èleny skupiny Administrators"
DefaultOwner0 = "Skupina Administrators"
DefaultOwner1 = "Tvùrce objektu"
ObCaseInsensitive = "Systémové objekty: Pro podsystémy nezaložené na systému Windows požadovat rozlišování malých a velkých písmen"

;================================ System cryptography =================================================================
FIPS="Kryptografie systému: K šifrování, výpoètu hodnoty hash a k podepisování používat algoritmus vyhovující standardu FIPS"

ForceHighProtection="Kryptografie systému: Vynutit silnou ochranu uživatelských klíèù uložených v poèítaèi"

CryptAllowNoUI="Pøi ukládání a používání nových klíèù není požadován vstup uživatele."
CryptAllowNoPass="Uživatel je vyzván pøi prvním použití klíèe."
CryptUsePass="Uživatel musí zadat heslo pøi každém použití klíèe."


;================================ System Settings =====================================================================
AuthenticodeEnabled = "Nastavení systému: Nastavit zásady omezení softwaru pomocí pravidel certifikátù pro spustitelné soubory systému Windows"
OptionalSubSystems = "Nastavení systému: Volitelné podsystémy"


Unit-Logons="pøihlášení"
Unit-Days="dnù"
Unit-Minutes="minut"
Unit-Seconds="sekund"
