

[Strings]
Msft = "Microsoft"

Mp-AsyncMac-DispName        = "Adaptador assíncrono de RAS"
Mp-L2tp-DispName            = "WAN Miniport (L2TP)"
Mp-Irda-DispName            = "Porta de infravermelhos"
Mp-IrModem-DispName         = "Porta de modem de infravermelhos"
Mp-Irda-LineName            = "Linha directa de infravermelhos"
Mp-IrModem-LineName         = "Linha de modem de infravermelhos"
Mp-Pptp-DispName            = "WAN Miniport (PPTP)"
Mp-Pptp-LineName            = "Linha VPN para RAS"
;Mp-Pptp-LineName must use ANSI characters, not UNICODE.
Mp-Pti-DispName             = "Paralelo directo"
Mp-Atalk-DispName           = "Miniport WAN (AppleTalk)"
Mp-Bh-DispName              = "Miniport WAN (monitor de rede)"
Mp-Ip-DispName              = "Miniport WAN (IP)"
Mp-Ipx-DispName             = "Miniport WAN (IPX)"
Mp-NbfIn-DispName           = "Miniport WAN (NetBEUI, Dial In)"
Mp-NbfOut-DispName          = "Miniport WAN (NetBEUI, Dial Out)"
Mp-Pppoe-DispName           = "WAN Miniport (PPPOE)"
Mp-Pppoe-LineName           = "RAS PPPOE Line"

Svc-Mp-AsyncMac-DispName    = "Controlador de média assíncrono de RAS"
Svc-Mp-L2tp-DispName        = "WAN Miniport (L2TP)"
Svc-Mp-Irda-DispName        = "Miniport WAN (IrDA)"
Svc-Mp-IrModem-DispName     = "Miniport WAN (modem IrDA)"
Svc-Mp-Pptp-DispName        = "WAN Miniport (PPTP)"
Svc-Mp-Pti-DispName         = "Paralelo directo"
Svc-NdisTapi-DispName       = "Controlador TAPI NDIS de acesso remoto"
Svc-NdisWan-DispName        = "Controlador WAN NDIS de acesso remoto"
Svc-PptpProtocol-DispName   = "Controlador de protocolo PPTP"
Svc-Ptilink-DispName        = "Controlador de ligações directas por porta paralela"
Svc-WanArp-DispName         = "Controlador ARP IP de acesso remoto"
Svc-Mp-Pppoe-DispName       = "Controlador de acesso remoto PPPOE"


