
































[Strings]
SceInfAdministrator = "Администратор"
SceInfAdmins = "Администраторы"
SceInfAcountOp = "Операторы учета"
SceInfAuthUsers = "Прошедшие проверку"
SceInfBackupOp = "Операторы архива"
SceInfDomainAdmins = "Администраторы домена"
SceInfDomainGuests = "Гости домена"
SceInfDomainUsers = "Пользователи домена"
SceInfEnterpriseDCs = "КОНТРОЛЛЕРЫ ДОМЕНА ПРЕДПРИЯТИЯ"
SceInfEveryone = "Все"
SceInfGuests = "Гости"
SceInfGuest = "Гость"
SceInfLocalService = "Local Service"
SceInfNetworkService = "Network Service"
SceInfPowerUsers = "Опытные пользователи"
SceInfPrintOp = "Операторы печати"
SceInfProgramFiles = "%ProgramFiles%"
SceInfProgramFilesx86 = "%ProgramFiles(x86)%"
SceInfCommonProgramFiles = "%CommonProgramFiles%"
SceInfRemoteDesktopUsers = "Пользователи удаленного рабочего стола"
SceInfReplicator = "Репликатор"
SceInfServerOp = "Операторы сервера"
SceInfUsers = "Пользователи"
SceInfMTSAdmins = "Администраторы MTS"
SceInfMTSImpersonators = "Олицетворители MTS"
SceInfMTSAdmin = "MTS_Admin"
SCEInfSysdir1 = "edit.com"
SCEInfSysdir2 = "edit.hlp"
SCEInfHelp1 = "signin.hlp"
