

[Strings]
Msft = "Microsoft"

ALG-DispName                = "Шлюз уровня приложения"
RasCli-DispName             = "Клиент удаленного доступа"
RasMan-DispName             = "Диспетчер подключений удаленного доступа"
RasSrv-DispName             = "Сервер удаленного доступа"
Steelhead-DispName          = "Сервер маршрутизации и удаленного доступа"

Snapin-Desc                 = "Маршрутизация и удаленный доступ"
Snapin-Group-Name           = "Администрирование"
Snapin-HelpText             = "Используйте диспетчер маршрутизации и удаленного доступа для настройки и управления службой маршрутизации и удаленного доступа."
Nt4RasAdmin-Desc            = "Диспетчер маршрутизации и RAS"
Nt4RasAdmin-Group-Name      = "Администрирование"

Svc-ALG-DispName            = "Служба шлюза уровня приложения"
Svc-ALG-Description         = "Обеспечивает поддержку протоколов уровня приложения для подключаемых модулей и доступ к сети и протоколам. Если эта служба отключена, любые службы, которые явно зависят от нее, не могут быть запущены."
Svc-RasAcd-DispName         = "Драйвер автоматических подключений удаленного доступа"
Svc-RasAuto-DispName        = "Диспетчер автоматических подключений удаленного доступа"
Svc-RasAuto-Description     = "Обнаруживает неудачные попытки подключения к удаленной сети или к удаленному компьютеру и предоставляет альтернативные методы подключения. Если эта служба остановлена, пользователям будет нужно устанавливать подключения вручную. Если эта служба отключена, любые службы, которые явно зависят от нее, не могут быть запущены."
Svc-RasMan-DispName         = "Диспетчер подключений удаленного доступа"
Svc-RasMan-Description      = "Управляет подключениями удаленного доступа и подключениями виртуальных частных сетей (VPN) к Интернету или другим удаленным сетям. Если эта служба остановлена, функционирование операционной системы может быть нарушено. Если эта служба отключена, любые службы, которые явно зависят от нее, не могут быть запущены."
Svc-RemoteAccess-DispName   = "Маршрутизация и удаленный доступ"
Svc-RemoteAccess-Description = "Настройка служб маршрутизации мультипротокольной связи между локальными сетями, между локальными и глобальными сетями, виртуальных частных сетей (VPN) и преобразования сетевых адресов (NAT) для клиентов и серверов данной сети. Если данная служба будет остановлена, все эти службы станут недоступными. Если данная служба отключена, все явно зависящие от нее службы запустить не удастся."
Svc-IpFilter-DispName       = "Драйвер фильтра IP-трафика"
Svc-IpInIp-DispName         = "Драйвер туннеля IP в IP"
Svc-IpNat-DispName          = "Транслятор сетевого IP-адреса"
Svc-IpxFilter-DispName      = "Драйвер фильтра IPX-трафика"
Svc-IpxForwarder-DispName   = "Драйвер пересылки  IPX-трафика"
Svc-NwSapAgent-DispName     = "Агент SAP"
Svc-SharedAccess-DispName   = "Брандмауэр Интернета (ICF) /Общий доступ к Интернету (ICS)"
Svc-SharedAccess-Description = "Обеспечивает поддержку служб трансляции адресов, адресации и разрешения имен или предотвращает вторжение служб в домашние сети или сети небольшого офиса. Если эта служба остановлена, такие сетевые службы как общий доступ к Интернету, разрешение имен и предотвращение вторжения, будут недоступны.  Если эта служба отключена, любые службы, которые явно зависят от нее, не могут быть запущены."
RtrMgr-Ip-DispName          = "Диспетчер маршрутизации TCP/IP"
RtrMgr-Ip-AutoDhcp-DispName = "DHCP-распределитель"
RtrMgr-Ip-Bootp-DispName    = "Агент DHCP-ретрансляции"
RtrMgr-Ip-DnsProxy-DispName = "Прокси-агент DNS"
RtrMgr-Ip-H323-DispName     = "Прокси-агент H.323"
RtrMgr-Ip-Igmp-DispName     = "Маршрутизатор и прокси IGMP"
RtrMgr-Ip-Nat-DispName      = "NAT - преобразование сетевых адресов"
RtrMgr-Ip-Ospf-DispName     = "OSPF - открытие кратчайшего пути первым"
RtrMgr-Ip-Rip-DispName      = "RIP версии 2 для IP"
RtrMgr-Ip-Alg-DispName      = "Служба шлюза уровня приложения (например, FTP)"
RtrMgr-Ip-Ftp-DispName      = "Прокси-агент FTP"
RtrMgr-Ipx-DispName         = "Диспетчер маршрутизации IPX"
RtrMgr-Ipx-Rip-DispName     = "RIP для IPX"
RtrMgr-Ipx-Sap-DispName     = "SAP для IPX"

Nt-Authentication           = "Windows - проверка подлинности"
Nt-Accounting               = "Windows - учет"
Radius-Authentication       = "RADIUS - проверка подлинности"
Radius-Accounting           = "RADIUS - учет"

Eap-DispName                = "Смарт-карта или иной сертификат"
PEAP-DispName				= "Защищенный EAP (PEAP)"
EAPMSCHAP-DispName			= "Защищенный пароль (EAP-MSCHAP v2)"
Chap-DispName               = "MD5-оклик"

ConnFolderName              = "Сетевые подключения"
ConnFolderSubDir            = "Стандартные\Связь"
ConnFolderTip               = "@%systemroot%\system32\netshell.dll,-1201"

NCW-Name                    = "Мастер новых подключений"
NCW-SubDir                  = "Стандартные\Связь"
NCW-ToolTip                 = "@%systemroot%\system32\netshell.dll,-1011"

CmDefaultCmdKeyName         = "Connection Manager Profile"
