

































[Strings]

;================================ Accounts ============================================================================
;Specified in UI code - Accounts: Administrator account status
;Specified in UI code - Accounts: Guest account status
;Specified in UI code - Accounts: Rename administrator account
;Specified in UI code - Accounts: Rename guest account
LimitBlankPasswordUse = "Comptes : restreindre l'utilisation de mots de passe vierge par le compte local à l'ouverture de session console"


;================================ Audit ===============================================================================
AuditBaseObjects="Audit : auditer l'accès des objets système globaux"
FullPrivilegeAuditing="Audit : auditer l'utilisation des privilèges de sauvegarde et de restauration"
CrashOnAuditFail="Audit : arrêter immédiatement le système s'il n'est pas possible de se connecter aux audits de sécurité"

;================================ Devices =============================================================================
AllocateDASD="Périphériques : permettre le formatage et l'éjection des supports amovibles"
AllocateDASD0="Administrateurs"
AllocateDASD1="Administrateurs et Utilisateurs avec pouvoir"
AllocateDASD2="Administrateurs et Utilisateurs interactifs"
AddPrintDrivers="Périphériques : empêcher les utilisateurs d'installer des pilotes d'imprimante"
AllocateCDRoms="Périphériques : autoriser l'accès au CD-ROM uniquement aux utilisateurs ayant ouvert une session localement"
AllocateFloppies="Périphériques : ne permettre l'accès aux disquettes qu'aux utilisateurs connectés localement"
DriverSigning="Périphériques : comportement d'installation d'un pilote non signé"
DriverSigning0="Réussite silencieuse "
DriverSigning1="Avertir, mais autoriser l'installation"
DriverSigning2="Ne pas autoriser l'installation"
UndockWithoutLogon="Périphériques : autoriser le retrait sans ouverture de session préalable"

;================================ Domain controller ====================================================================
SubmitControl="Contrôleur de domaine : permettre aux opérateurs du serveur de planifier des tâches"
RefusePWChange="Contrôleur de domaine : refuser les modifications de mot de passe du compte ordinateur"
LDAPServerIntegrity = "Contrôleur de domaine : conditions requises pour la signature de serveur LDAP"
LDAPServer1 = "Aucun"
LDAPServer2 = "Nécessite la signature"

;================================ Domain member ========================================================================
DisablePWChange="Membre de domaine : désactive les modifications de mot de passe du compte ordinateur"
MaximumPWAge="Membre de domaine : âge maximal du mot de passe du compte ordinateur"
SignOrSeal="Membre de domaine : crypter ou signer numériquement les données des canaux sécurisés (toujours)"
SealSecureChannel="Membre de domaine : crypter numériquement les données des canaux sécurisés (lorsque cela est possible)"
SignSecureChannel="Membre de domaine : signer numériquement les données des canaux sécurisés (lorsque cela est possible)"
StrongKey="Membre de domaine : nécessite une clé de session forte (Windows 2000 ou ultérieur)"

;================================ Interactive logon ====================================================================
DisableCAD = "Ouverture de session interactive : ne pas demander la combinaison de touches Ctrl+Alt+Suppr."
DontDisplayLastUserName = "Ouverture de session interactive : ne pas afficher le dernier nom d'utilisateur"
LegalNoticeText = "Ouverture de session interactive : contenu du message pour les utilisateurs essayant de se connecter"
LegalNoticeCaption = "Ouverture de session interactive : titre du message pour les utilisateurs essayant de se connecter"
CachedLogonsCount = "Ouvertures de sessions interactives : nombre d'ouvertures de sessions précédentes réalisées en utilisant le cache (lorsqu'aucun contrôleur de domaine n'est disponible)"
PasswordExpiryWarning = "Ouverture de session interactive : prévenir l'utilisateur qu'il doit changer son mot de passe avant qu'il n'expire"
ForceUnlockLogon = "Ouverture de session interactive : nécessite l'authentification par le contrôleur de domaine pour le déverrouillage de la station de travail."
ScForceOption = "Ouverture de session interactive : carte à puce nécessaire"
ScRemove = "Ouverture de session interactive : comportement lorsque la carte à puce est retirée"
ScRemove0 = "Aucune action"
ScRemove1 = "Verrouiller la station de travail"
ScRemove2 = "Forcer la fermeture de session"

;================================ Microsoft network client =============================================================
RequireSMBSignRdr="Client réseau Microsoft : communications signées numériquement (toujours)"
EnableSMBSignRdr="Client réseau Microsoft : communications signées numériquement (lorsque le serveur l'accepte)"
EnablePlainTextPassword="Client réseau Microsoft : envoyer un mot de passe non crypté aux serveurs SMB tierce partie"

;================================ Microsoft network server =============================================================
AutoDisconnect="Serveur réseau Microsoft : durée d'inactivité avant la suspension d'une session"
RequireSMBSignServer="Serveur réseau Microsoft : communications signées numériquement (toujours)"
EnableSMBSignServer="Serveur réseau Microsoft : communications signées numériquement (lorsque le serveur l'accepte)"
EnableForcedLogoff="Serveur réseau Microsoft : déconnecter les clients à l'expiration du délai de la durée de session"

;================================ Network access =======================================================================
;Specified in UI code - Network access: Allow anonymous SID/Name translation
DisableDomainCreds = "Accès réseau : ne pas autoriser le stockage d'informations d'identification ou des passeports .NET pour l'authentification du réseau"
RestrictAnonymousSAM = "Accès réseau : ne pas autoriser l'énumération anonyme des comptes SAM"
RestrictAnonymous = "Accès réseau : ne pas autoriser l'énumération anonyme des comptes et partages SAM"
EveryoneIncludesAnonymous = "Accès réseau : les autorisations spécifiques des utilisateurs appartenant au groupe Tout le monde s'appliquent aux utilisateurs anonymes"
RestrictNullSessAccess = "Accès réseau : restreindre l'accès anonyme aux canaux nommés et aux partages"
NullPipes = "Accès réseau : les canaux nommés qui sont accessibles de manière anonyme"
NullShares = "Accès réseau : les partages qui sont accessibles de manière anonyme"
AllowedPaths = "Accès réseau : chemins et sous-chemins de Registre accessibles à distance"
AllowedExactPaths = "Accès réseau : les chemins de Registre accessibles à distance"
ForceGuest = "Accès réseau : modèle de partage et de sécurité pour les comptes locaux"
Classic = "Classique - les utilisateurs locaux s'authentifient eux-mêmes"
GuestBased = "Invité seul - les utilisateurs locaux s'authentifient en tant qu'invités"

;================================ Network security =====================================================================
;Specified in UI code - Network security: Enforce logon hour restrictions
NoLMHash = "Sécurité réseau : ne pas stocker de valeurs de hachage de niveau Lan Manager sur la prochaine modification de mot de passe"
LmCompatibilityLevel = "Sécurité réseau : niveau d'authentification Lan Manager"
LMCLevel0 = "Envoyer les réponses LM et NTLM"
LMCLevel1 = "Envoyer LM et NTLM - utiliser la sécurité de session NTLM version 2 si négociée"
LMCLevel2 = "Envoyer uniquement les réponses NTLM"
LMCLevel3 = "Envoyer uniquement les réponses NTLM v. 2"
LMCLevel4 = "Envoyer uniquement les réponses NTLMv2\refuser LM"
LMCLevel5 = "Envoyer des réponses NTLM version 2 uniquement\refuser LM et NTLM"
NTLMMinClientSec = "Sécurité réseau : sécurité de session minimale pour les clients basés sur NTLM SSP (y compris RPC sécurisé)"
NTLMMinServerSec = "Sécurité réseau : sécurité de session minimale pour les serveurs basés sur NTLM SSP (y compris RPC sécurisé)"
NTLMIntegrity = "Nécessite l'intégrité des messages"
NTLMConfidentiality = "Nécessite la confidentialité des messages"
NTLMv2Session = "Nécessite une sécurité de session NTLMv2"
NTLM128 = "Exiger un niveau de cryptage à 128 bits"
LDAPClientIntegrity = "Sécurité réseau : conditions requises pour la signature de client LDAP"
LDAPClient0 = "Aucun"
LDAPClient1 = "Négociation des signatures"
LDAPClient2 = "Nécessite la signature"

;================================ Recovery console ====================================================================
RCAdmin="Console de récupération : autoriser l'ouverture de session d'administration automatique"
RCSet="Console de récupération : autoriser la copie de disquettes et l'accès à tous les lecteurs et dossiers"

;================================ Shutdown ============================================================================
ShutdownWithoutLogon="Arrêt : permet au système d'être arrêté sans avoir à se connecter"
ClearPageFileAtShutdown="Arrêt : effacer le fichier d'échange de mémoire virtuelle"

ProtectionMode = "Objets système : renforcer les autorisations par défaut des objets système internes (comme les liens de symboles)"
NoDefaultAdminOwner = "Objets système : propriétaire par défaut pour les objets créés par les membres du groupe Administrateurs"
DefaultOwner0 = "Groupe Administrateurs"
DefaultOwner1 = "Créateur d'objet"
ObCaseInsensitive = "Objets système : les différences entre majuscules et minuscules ne doivent pas être prises en compte pour les sous-systèmes autres que Windows"

;================================ System cryptography =================================================================
FIPS="Cryptographie système : utilisez des algorithmes compatibles FIPS pour le cryptage, le hachage et la signature"

ForceHighProtection="Cryptographie système : force une protection forte des clés utilisateur enregistrées sur l'ordinateur"

CryptAllowNoUI="L'utilisateur n'a pas besoin d'entrer de mot de passe lorsque de nouvelles clés sont enregistrées et utilisées"
CryptAllowNoPass="L'utilisateur doit entrer un mot de passe à la première utilisation de la clé"
CryptUsePass="L'utilisateur doit entrer un mot de passe à chaque utilisation de la clé"


;================================ System Settings =====================================================================
AuthenticodeEnabled = "Paramètres système : utiliser les règles de certificat avec les exécutables Windows pour les stratégies de restriction logicielle"
OptionalSubSystems = "Paramètres système : Sous-systèmes optionnels"


Unit-Logons="Ouvertures de session"
Unit-Days="derniers jours"
Unit-Minutes="minutes"
Unit-Seconds="secondes"
