

[Strings]
Msft = "Microsoft"

ALG-DispName                = "Uygulama Katmaný Að Geçidi"
RasCli-DispName             = "Çevirmeli Ýstemci"
RasMan-DispName             = "Uzaktan Eriþim Baðlantý Yöneticisi"
RasSrv-DispName             = "Çevirmeli Sunucu"
Steelhead-DispName          = "Steelhead"

Snapin-Desc                 = "Yönlendirme ve Uzaktan Eriþim"
Snapin-Group-Name           = "Yönetimsel Araçlar"
Snapin-HelpText             = "Yönlendirme ve Uzaktan Eriþim hizmetini yapýlandýrmak ve yönetmek için Yönlendirme ve Uzaktan Eriþim'i kullan."
Nt4RasAdmin-Desc            = "Yönlendirme ve RAS Yönetimi"
Nt4RasAdmin-Group-Name      = "Yönetimsel Araçlar"

Svc-ALG-DispName            = "Uygulama Katmaný Að Geçidi Hizmeti"
Svc-ALG-Description         = "Uygulama düzeyi iletiþim kuralý eklentilerine destek saðlayýp að/iletiþim kuralý baðlantýsýný etkinleþtirir. Bu hizmet devre dýþý býrakýlýrsa açýk olarak bu hizmete baðlý olan hizmetler baþlatýlamaz."
Svc-RasAcd-DispName         = "Uzaktan Eriþim Otomatik Baðlantý Sürücüsü"
Svc-RasAuto-DispName        = "Uzaktan Eriþim Otomatik Baðlantý Yöneticisi"
Svc-RasAuto-Description     = "Uzak að ya da bilgisayara baþarýsýz baðlanma giriþimlerini algýlayýp baðlantý için farklý yöntemler saðlar. Bu hizmet devre dýþý býrakýlýrsa açýk olarak bu hizmete baðlý olan hizmetler baþlatýlamaz."
Svc-RasMan-DispName         = "Uzaktan Eriþim Baðlantý Yöneticisi"
Svc-RasMan-Description      = "Bu bilgisayardan Internet ya da baþka uzak aðlara çevirmeli ve sanal özel að (VPN) baðlantýlarýný yönetir. Bu hizmet durdurulursa iþletim sistemi doðru çalýþmayabilir. Bu hizmet devre dýþý býrakýlýrsa açýk olarak bu hizmete baðlý olan hizmetler baþlatýlamaz."
Svc-RemoteAccess-DispName   = "Yönlendirme ve Uzaktan Eriþim"
Svc-RemoteAccess-Description = "Bu aðdaki istemci ve sunucular için çok iletiþim kurallý LAN-LAN, LAN-WAN, sanal özel að (VPN) ve að adres çevirisi (NAT) hizmetlerini etkinleþtirir. Bu hizmet durdurulursa, bu hizmetler kullanýlamaz. Bu hizmet devre dýþý býrakýlýrsa açýk olarak bu hizmete baðlý olan hizmetler baþlatýlamaz."
Svc-IpFilter-DispName       = "IP Trafik Süzgeci Sürücüsü"
Svc-IpInIp-DispName         = "IP Tünel Sürücüsü içinde"
Svc-IpNat-DispName          = "IP Að Adresi Çevirmeni"
Svc-IpxFilter-DispName      = "IPX Trafik Süzgeci Sürücüsü"
Svc-IpxForwarder-DispName   = "IPX Trafik Ýleticisi Sürücüsü"
Svc-NwSapAgent-DispName     = "SAP Aracýsý"
Svc-SharedAccess-DispName   = "Internet Baðlantýsý Güvenlik Duvarý (ICF) / Internet Baðlantý Paylaþýmý (ICS)"
Svc-SharedAccess-Description = "Ev ya da küçük iþyeri aðlarý için að adresi çevirme, adresleme, ad çözümleme ve/veya yetkisiz giriþ engelleme hizmetleri saðlar. Bu hizmet durdurulursa, Internet paylaþýmý, ad çözümleme, adresleme ve/veya yetkisiz giriþ engelleme kullanýlamaz.  Bu hizmet devre dýþý býrakýlýrsa açýk olarak bu hizmete baðlý olan hizmetler baþlatýlamaz."
RtrMgr-Ip-DispName          = "TCP/IP Yönlendirme Yöneticisi"
RtrMgr-Ip-AutoDhcp-DispName = "DHCP Bulucusu"
RtrMgr-Ip-Bootp-DispName    = "DHCP Aktarma Aracýsý"
RtrMgr-Ip-DnsProxy-DispName = "DNS Proxy Aracýsý"
RtrMgr-Ip-H323-DispName     = "H.323 Proxy Agent"
RtrMgr-Ip-Igmp-DispName     = "IGMP Yönlendirici ve Proxy"
RtrMgr-Ip-Nat-DispName      = "Að Adresi Çevirisi (NAT)"
RtrMgr-Ip-Ospf-DispName     = "Önce En Kýsa Yolu Aç (OSPF)"
RtrMgr-Ip-Rip-DispName      = "Internet Ýletiþim Kurallarý için RIP Sürüm 2"
RtrMgr-Ip-Alg-DispName      = "Uygulama Katmaný Að Geçidi Hizmeti (örneðin FTP)"
RtrMgr-Ip-Ftp-DispName      = "Ftp Proxy Aracýsý"
RtrMgr-Ipx-DispName         = "IPX Yönlendirme Yöneticisi"
RtrMgr-Ipx-Rip-DispName     = "IPX için RIP"
RtrMgr-Ipx-Sap-DispName     = "IPX için SAP"

Nt-Authentication           = "Windows Kimlik Doðrulama"
Nt-Accounting               = "Windows Muhasebe"
Radius-Authentication       = "RADIUS Kimlik Doðrulamasý"
Radius-Accounting           = "RADIUS Muhasebe"

Eap-DispName                = "Smart Card veya diðer Sertifika"
PEAP-DispName				= "Korumalý EAP (PEAP)"
EAPMSCHAP-DispName			= "Güvenli parola (EAP-MSCHAP v2)"
Chap-DispName               = "MD5-Çekiþme"

ConnFolderName              = "Að Baðlantýlarý"
ConnFolderSubDir            = "Donatýlar\Ýletiþim"
ConnFolderTip               = "@%systemroot%\system32\netshell.dll,-1201"

NCW-Name                    = "Yeni Baðlantý Sihirbazý"
NCW-SubDir                  = "Donatýlar\Ýletiþim"
NCW-ToolTip                 = "@%systemroot%\system32\netshell.dll,-1011"

CmDefaultCmdKeyName         = "Connection Manager Profile"
