

[Strings]
Msft = "Microsoft"

Mp-AsyncMac-DispName        = "Adaptador asínc. de RAS"
Mp-L2tp-DispName            = "Minipuerto WAN (L2TP)"
Mp-Irda-DispName            = "Puerto de infrarrojos"
Mp-IrModem-DispName         = "Puerto de infrarrojos para módem"
Mp-Irda-LineName            = "Línea directa de infrarrojos"
Mp-IrModem-LineName         = "Línea de infrarrojos para módem"
Mp-Pptp-DispName            = "Minipuerto WAN (PPTP)"
Mp-Pptp-LineName            = "Linea VPN para RAS"
;Mp-Pptp-LineName must use ANSI characters, not UNICODE.
Mp-Pti-DispName             = "Paralelo directo"
Mp-Atalk-DispName           = "Minipuerto WAN (AppleTalk)"
Mp-Bh-DispName              = "Minipuerto WAN (Monitor de red)"
Mp-Ip-DispName              = "Minipuerto WAN (IP)"
Mp-Ipx-DispName             = "Minipuerto WAN (IPX)"
Mp-NbfIn-DispName           = "Minipuerto WAN (NetBEUI, llamada entrante)"
Mp-NbfOut-DispName          = "Minipuerto WAN (NetBEUI, llamada saliente)"
Mp-Pppoe-DispName           = "Minipuerto WAN (PPPOE)"
Mp-Pppoe-LineName           = "Línea PPPOE RAS"

Svc-Mp-AsyncMac-DispName    = "Controlador de medios asíncronos de RAS"
Svc-Mp-L2tp-DispName        = "Minipuerto WAN (L2TP)"
Svc-Mp-Irda-DispName        = "Minipuerto WAN (IrDA)"
Svc-Mp-IrModem-DispName     = "Minipuerto WAN (Módem IrDA)"
Svc-Mp-Pptp-DispName        = "Minipuerto WAN (PPTP)"
Svc-Mp-Pti-DispName         = "Paralelo directo"
Svc-NdisTapi-DispName       = "Controlador TAPI NDIS de acceso remoto"
Svc-NdisWan-DispName        = "Controlador WAN NDIS de acceso remoto"
Svc-PptpProtocol-DispName   = "Controlador de protocolo PPTP"
Svc-Ptilink-DispName        = "Controlador de vínculo paralelo directo"
Svc-WanArp-DispName         = "Controlador ARP IP de acceso remoto"
Svc-Mp-Pppoe-DispName       = "Controlador de acceso remoto PPPOE"


