

[Strings]
Msft = "Microsoft"

ALG-DispName                = "Alkalmazási réteg átjárója"
RasCli-DispName             = "Telefonos ügyfél"
RasMan-DispName             = "Távelérési csatlakozáskezelõ"
RasSrv-DispName             = "Tárcsázó kiszolgáló"
Steelhead-DispName          = "Steelhead"

Snapin-Desc                 = "Útválasztás és távelérés"
Snapin-Group-Name           = "Felügyeleti eszközök"
Snapin-HelpText             = "Az Útválasztás és távelérés segítségével konfigurálhatja az útválasztási és távelérési szolgáltatásokat."
Nt4RasAdmin-Desc            = "Útválasztás és RAS-felügyelet"
Nt4RasAdmin-Group-Name      = "Felügyeleti eszközök"

Svc-ALG-DispName            = "Alkalmazási réteg átjárószolgáltatása"
Svc-ALG-Description         = "Alkalmazásszintû beépülõ protokollmodulok támogatása, hálózati és protokollszintû kapcsolatképesség lehetõvé tétele. Ha letiltja a szolgáltatást, a tõle függõ szolgáltatások nem fognak elindulni."
Svc-RasAcd-DispName         = "Távelérés - automatikus kapcsolódás illesztõprogramja"
Svc-RasAuto-DispName        = "Távelérés - automatikus kapcsolódás kezelõje"
Svc-RasAuto-Description     = "Érzékeli a távoli hálózatokhoz vagy számítógépekhez való sikertelen kapcsolódási kísérleteket, és más módszereket biztosít a csatlakozáshoz. A szolgáltatás leállítása esetén a felhasználóknak saját maguknak kell kapcsolatot létesíteniük. Ha letiltja ezt a szolgáltatást, a közvetlenül tõle függõ szolgáltatások nem indulnak."
Svc-RasMan-DispName         = "Távelérési csatlakozáskezelõ"
Svc-RasMan-Description      = "A helyi számítógéprõl az internetre vagy távoli hálózatokba irányuló telefonos és virtuális magánhálózati (VPN) kapcsolatok kezelése. A szolgáltatás leállítása esetén elõfordulhat, hogy az operációs rendszer nem mûködik megfelelõen. Ha letiltja ezt a szolgáltatást, a közvetlenül tõle függõ szolgáltatások nem indulnak."
Svc-RemoteAccess-DispName   = "Útválasztás és távelérés"
Svc-RemoteAccess-Description = "Többprotokollos LAN - LAN, LAN - WAN, virtuális magánhálózati (VPN) és hálózati címfordítási (NAT) útválasztási szolgáltatásokat tesz elérhetõvé a hálózat kiszolgálói és ügyfelei számára. a szolgáltatás leállítása esetén ezek a szolgáltatások nem érhetõk el. Ha letiltja ezt a szolgáltatást, a közvetlenül tõle függõ szolgáltatások nem indulnak."
Svc-IpFilter-DispName       = "IP-forgalomszûrõ illesztõprogram"
Svc-IpInIp-DispName         = "IP-be bújtatott IP illesztõprogramja"
Svc-IpNat-DispName          = "IP - hálózati címfordító"
Svc-IpxFilter-DispName      = "IPX-forgalomszûrõ illesztõprogram"
Svc-IpxForwarder-DispName   = "IPX-forgalomtovábbító illesztõprogram"
Svc-NwSapAgent-DispName     = "SAP-ügynök"
Svc-SharedAccess-DispName   = "Internetkapcsolat tûzfala (ICF) / Internetkapcsolat megosztása (ICS)"
Svc-SharedAccess-Description = "Hálózati címfordítási, névfeloldási és/vagy behatolásvédelmi szolgáltatások otthoni vagy kisebb munkahelyi hálózat számára. Ha leállítja a szolgáltatást, nem lesznek használhatók az olyan hálózati szolgáltatások, mint például az internetmegosztás, a névfeloldás, a címzés és a külsõ behatolás elleni védelem. Ha letiltja a szolgáltatást, a tõle függõ szolgáltatások nem fognak elindulni."
RtrMgr-Ip-DispName          = "TCP/IP-útválasztókezelõ"
RtrMgr-Ip-AutoDhcp-DispName = "DHCP-címfoglaló"
RtrMgr-Ip-Bootp-DispName    = "DHCP-továbbítóügynök"
RtrMgr-Ip-DnsProxy-DispName = "DNS-proxyügynök"
RtrMgr-Ip-H323-DispName     = "H.323 proxyügynök"
RtrMgr-Ip-Igmp-DispName     = "IGMP útválasztó és proxy"
RtrMgr-Ip-Nat-DispName      = "Hálózati címfordítás (NAT)"
RtrMgr-Ip-Ospf-DispName     = "Open Shortest Path First (OSPF)"
RtrMgr-Ip-Rip-DispName      = "RIP 2. verzió IP-hez"
RtrMgr-Ip-Alg-DispName      = "Alkalmazási réteg átjárószolgáltatása (pl. FTP)"
RtrMgr-Ip-Ftp-DispName      = "Ftp-proxyügynök"
RtrMgr-Ipx-DispName         = "IPX-útválasztókezelõ"
RtrMgr-Ipx-Rip-DispName     = "RIP az IPX számára"
RtrMgr-Ipx-Sap-DispName     = "SAP az IPX számára"

Nt-Authentication           = "Windows-hitelesítés"
Nt-Accounting               = "Windows-számlázás"
Radius-Authentication       = "RADIUS-hitelesítés"
Radius-Accounting           = "RADIUS-számlázás"

Eap-DispName                = "Intelligens kártya vagy más tanúsítvány"
PEAP-DispName				= "Védett EAP (PEAP)"
EAPMSCHAP-DispName			= "Biztonságos jelszó (EAP-MSCHAP v2)"
Chap-DispName               = "MD5-Challenge"

ConnFolderName              = "Hálózati kapcsolatok"
ConnFolderSubDir            = "Kellékek\Kommunikáció"
ConnFolderTip               = "@%systemroot%\system32\netshell.dll,-1201"

NCW-Name                    = "Új kapcsolat varázsló"
NCW-SubDir                  = "Kellékek\Kommunikáció"
NCW-ToolTip                 = "@%systemroot%\system32\netshell.dll,-1011"

CmDefaultCmdKeyName         = "Connection Manager Profile"
